1 1 1 1 1 1 1 1 1 1 1 1 1 1 1 1 1 1 1 1 1 1 1 1 1 1 1 1 1 1 1 1 1 1 1 1 1 1 1 1
1 0 0 0 0 0 0 0 0 0 1 2 3 4 0 0 1 2 3 4 0 0 0 0 0 0 0 0 0 0 0 1 2 3 4 0 0 0 0 1
1 0 0 0 0 0 0 0 0 25 26 27 28 29 0 25 26 27 28 29 0 0 0 0 0 0 0 0 0 0 25 26 27 28 29 0 0 0 0 1
1 16 17 18 19 20 21 22 23 24 51 52 53 54 0 50 51 52 53 16 17 18 19 20 21 22 23 24 0 0 50 51 52 53 54 0 0 0 0 1
1 41 42 43 44 45 46 47 48 49 76 77 78 79 0 75 76 77 78 41 42 43 44 45 46 47 48 49 0 0 75 76 77 78 79 0 0 0 0 1
1 66 67 68 69 70 71 72 73 74 101 102 103 104 0 100 101 102 103 66 67 68 69 70 71 72 73 74 0 0 100 101 102 103 104 0 0 0 0 1
125 126 127 128 126 127 128 126 127 128 126 127 128 126 127 128 126 127 128 126 127 128 126 127 128 126 127 128 126 127 128 126 127 128 129 0 0 0 0 1
150 151 152 153 151 152 153 151 152 153 151 152 153 151 152 153 151 152 153 151 152 153 151 152 153 151 152 153 151 152 153 151 152 153 154 0 0 0 0 1
175 176 177 178 176 177 178 176 177 178 176 177 178 176 177 178 176 177 178 176 177 178 176 177 178 176 177 178 176 177 178 176 177 178 179 0 0 0 0 1
200 201 202 203 201 202 203 201 202 203 201 202 203 201 202 203 201 202 203 201 202 203 201 202 203 201 202 203 201 202 203 201 202 203 204 0 0 0 0 1
225 226 256 256 257 258 258 258 258 258 226 227 228 226 227 228 226 227 228 256 256 256 256 256 256 256 256 256 256 256 256 257 258 228 229 0 0 0 0 1
256 256 281 256 256 256 257 258 258 258 258 258 258 258 258 258 256 256 256 281 281 281 281 281 281 281 281 281 281 281 281 256 257 258 0 0 0 0 0 1
256 256 257 258 258 257 256 256 257 256 256 257 256 256 256 256 256 256 256 257 258 306 306 306 306 306 306 306 306 256 257 258 258 283 0 0 0 0 0 1
281 281 256 256 257 258 258 258 282 281 281 282 281 281 281 281 281 281 281 256 256 256 256 256 256 256 257 258 258 258 282 283 283 308 0 0 0 0 0 1
306 306 281 281 256 257 256 257 258 258 258 307 306 306 306 306 306 306 256 256 256 256 256 256 281 281 282 283 256 256 256 256 256 256 257 258 0 0 0 1
1 0 306 306 281 282 256 256 256 256 256 256 256 256 256 256 256 256 281 281 281 281 281 281 306 306 307 308 281 256 257 258 257 258 282 283 0 0 0 1
1 0 0 0 306 307 281 281 281 281 281 281 281 281 281 281 281 281 306 306 306 306 306 306 307 308 0 256 257 258 282 283 282 283 307 308 0 0 0 1
1 0 0 0 0 0 306 306 306 306 306 306 306 306 306 306 306 306 307 308 257 258 257 258 258 258 257 258 282 283 307 308 307 308 0 0 0 0 0 1
1 0 0 0 0 0 0 0 0 0 0 306 307 308 308 307 308 308 307 308 282 283 282 283 283 283 282 283 307 308 0 0 0 0 0 0 0 0 0 1
1 1 1 1 1 1 1 1 1 1 1 1 1 1 1 1 1 1 1 306 307 308 307 308 308 308 307 308 1 1 1 1 1 1 1 1 1 1 1 1
