1 1 1 1 1 1 1 1 1 1 1 1 1 1 1 1 1 1 1 1 1 1 1 1 1 1 1 1 1 1 1 1 1 1 1 1 1 1 1 1
1 150 151 152 153 154 150 151 152 153 154 0 0 0 0 0 0 0 0 0 0 0 0 0 0 0 0 0 0 0 0 0 0 0 0 0 0 0 0 1
1 175 176 177 178 179 175 176 177 178 179 0 0 0 0 0 0 0 0 0 0 0 0 0 0 0 0 0 0 0 0 0 0 0 0 0 0 0 0 1
1 200 201 202 203 204 200 201 202 203 204 0 0 0 0 0 0 0 0 0 0 0 0 0 0 0 0 0 0 0 0 0 0 0 0 0 0 0 0 1
1 225 226 227 228 229 225 226 227 228 229 0 0 0 0 0 0 0 0 0 0 0 0 0 0 0 0 0 0 0 0 0 0 0 0 0 0 0 0 1
1 150 151 152 153 154 150 151 152 153 154 0 0 0 0 0 0 0 0 0 0 0 0 0 0 0 0 0 0 0 0 0 0 0 0 0 0 0 0 1
1 175 176 177 178 179 175 176 177 178 179 0 0 0 0 0 0 0 0 0 0 0 0 0 0 0 0 0 0 0 0 0 0 0 0 0 0 0 0 1
1 200 201 202 203 204 200 201 202 203 204 0 0 0 0 0 150 151 152 153 154 150 151 152 153 154 150 151 152 153 154 0 0 0 0 0 0 0 0 1
1 225 226 227 228 229 225 226 227 228 229 0 0 0 0 0 175 176 177 178 179 175 176 177 178 179 175 176 177 178 179 0 0 0 0 0 0 0 0 1
1 0 0 0 0 0 0 0 0 0 0 0 0 0 0 0 200 201 202 203 204 200 201 202 203 204 200 201 202 203 204 0 0 0 0 0 0 0 0 1
1 0 0 0 0 0 0 0 0 0 0 0 0 0 0 0 225 226 227 228 229 225 226 227 228 229 150 151 152 153 154 0 0 0 0 0 0 0 0 1
1 0 0 0 0 0 0 0 0 0 0 0 0 0 0 0 150 151 152 153 154 0 0 0 0 0 150 151 152 153 154 0 0 0 0 0 0 0 0 1
1 0 0 0 0 0 0 0 0 0 0 0 0 0 0 0 175 176 177 178 179 0 0 0 0 0 175 176 177 178 179 0 0 0 0 0 0 0 0 1
1 0 0 0 0 0 0 0 0 0 0 0 0 0 0 0 200 201 202 203 204 0 0 0 0 0 200 201 202 203 204 0 0 0 0 0 0 0 0 1
1 0 0 0 0 0 0 0 0 0 0 0 0 0 0 0 225 226 227 228 229 0 0 0 0 0 225 150 151 152 153 150 151 152 150 151 152 153 154 1
1 150 151 152 153 154 150 151 152 153 154 150 151 152 153 154 150 151 152 153 154 0 0 0 0 0 0 175 176 177 178 175 176 177 175 176 177 178 179 153
1 175 176 177 178 179 175 176 177 178 179 175 176 177 178 179 175 176 177 178 179 0 0 0 0 0 0 200 201 202 203 200 201 202 200 201 202 203 204 178
1 200 201 202 203 204 200 201 202 203 204 200 201 202 203 204 200 201 202 203 204 0 0 0 0 0 0 225 226 227 228 225 226 227 225 226 227 228 229 203
1 225 226 227 228 229 225 226 227 228 229 225 226 227 228 229 225 226 227 228 229 0 0 0 0 0 0 0 0 0 0 0 0 0 0 0 225 226 227 228
1 1 1 1 1 1 1 1 1 1 1 1 1 1 1 1 1 1 1 1 1 1 1 1 1 1 1 1 1 1 1 1 1 1 1 1 1 1 1 1
