310 310 311 310 311 310 310 311 312 310 311 312 310 310 311 312 312 310 311 312 310 311 312 310 311 312 13 14 312 310 311 312 310 311 310 311 312 310 311 312
310 311 312 335 310 335 335 310 311 335 310 310 335 335 310 311 312 335 336 337 335 336 337 310 311 312 38 39 311 335 310 311 335 336 335 310 311 310 311 312
335 336 337 336 335 336 337 335 336 337 335 335 336 337 335 336 337 335 336 337 335 336 337 335 336 337 63 64 336 337 335 336 337 336 337 335 336 335 336 337
0 0 0 0 0 393 394 0 0 0 0 0 0 0 0 0 0 0 0 0 0 0 0 0 0 0 88 89 0 0 0 0 0 0 0 0 0 0 0 0
0 0 0 0 0 418 419 0 0 0 0 0 0 0 0 0 0 0 0 0 0 0 0 0 0 0 0 0 0 0 0 0 0 0 0 390 0 0 0 0
0 0 0 0 0 0 0 0 0 0 0 0 0 0 0 0 0 0 0 0 0 0 0 0 0 0 0 0 0 0 0 0 0 0 0 0 0 0 0 0
0 0 0 0 0 0 0 0 0 0 0 0 0 0 0 0 0 0 0 0 0 0 0 0 0 0 0 0 0 0 0 0 0 0 0 0 0 0 0 0
0 0 0 0 0 0 0 0 0 0 0 0 0 0 0 0 0 0 0 0 0 0 0 0 0 0 0 0 0 0 0 0 0 0 0 0 0 0 0 0
0 0 0 0 0 0 0 0 0 0 0 0 0 0 0 0 0 0 0 0 0 0 0 0 0 0 0 0 0 0 0 0 0 0 0 0 0 0 0 0
0 0 0 0 0 0 0 0 0 0 0 0 0 0 0 0 0 0 0 0 0 0 0 0 0 0 0 0 0 0 0 0 0 0 0 0 0 0 0 0
0 0 0 0 0 0 0 0 0 0 0 0 0 0 0 0 0 0 0 0 0 0 0 0 0 0 0 0 0 0 0 0 0 0 0 0 0 0 0 0
0 0 0 0 0 0 0 0 0 0 0 0 0 0 0 0 0 0 0 0 0 0 391 392 0 0 0 0 0 0 0 0 0 0 0 0 0 162 163 0
0 0 0 0 0 0 0 0 0 0 0 0 0 0 0 0 0 0 0 0 0 0 416 417 0 0 0 0 0 0 0 0 0 0 0 0 0 187 188 0
0 0 0 390 0 0 0 0 0 0 0 0 0 0 0 0 0 0 0 0 0 0 0 0 0 0 0 0 0 0 0 0 0 0 0 0 0 212 213 0
0 0 0 0 0 0 0 0 0 0 0 0 0 0 0 0 0 0 0 0 0 0 0 0 0 0 0 0 0 0 0 0 0 0 0 0 0 0 0 0
0 0 0 0 0 0 0 0 0 0 0 0 0 281 282 283 0 0 0 0 0 0 0 0 0 0 0 0 0 0 0 0 0 0 0 0 0 0 0 0
281 282 281 281 282 283 283 281 282 283 281 282 283 281 282 283 281 282 283 281 282 283 281 282 283 281 282 281 282 281 282 283 281 282 281 282 283 281 282 283
481 482 483 484 481 482 483 484 481 482 483 484 481 482 483 484 481 482 483 484 481 482 483 484 481 482 483 484 481 482 483 484 481 482 483 484 481 481 482 483
506 507 508 509 506 507 508 509 506 507 508 509 506 507 508 509 506 507 508 509 506 507 508 509 506 507 508 509 506 507 508 509 506 507 508 509 506 506 507 508
506 507 508 509 506 507 508 509 506 507 508 509 506 507 508 509 506 507 508 509 506 507 508 509 506 507 508 509 506 507 508 509 506 507 508 509 506 507 508 509
