1 1 1 1 1 1 1 1 1 1 1 1 1 1 1 1 1 1 1 1 1 1 1 1 1 1 1 1 1 1 1 1 1 1 1 1 1 1 1 1
1 0 0 0 0 0 0 0 0 0 0 0 0 0 0 0 0 0 0 0 0 203 204 205 206 207 208 209 210 211 0 0 0 0 0 0 0 0 0 1
1 0 0 0 0 0 0 0 0 0 0 0 0 0 0 0 0 0 0 0 0 203 204 205 206 207 208 209 210 211 0 0 0 0 0 0 0 0 0 1
1 0 0 0 0 0 0 0 203 203 204 205 206 207 208 209 210 211 0 0 0 203 204 205 206 207 208 209 210 211 0 0 0 0 0 0 0 0 0 1
1 0 0 0 0 0 0 0 228 203 203 204 205 206 207 208 209 210 211 0 203 204 205 206 207 208 209 210 211 211 0 0 0 0 0 0 0 0 0 1
1 0 0 0 0 0 0 0 253 228 228 229 230 231 232 233 234 235 236 0 203 204 205 206 207 208 209 210 211 236 0 0 0 0 0 0 0 0 0 1
1 0 0 0 0 0 0 0 278 253 253 254 255 256 257 258 259 260 261 203 204 205 206 207 208 209 210 211 236 261 0 0 0 0 0 0 0 0 0 1
1 0 0 0 0 0 0 0 303 278 278 279 203 204 205 206 207 208 209 210 211 206 207 208 209 210 211 211 261 286 206 207 208 209 210 211 0 0 0 1
1 0 0 0 0 0 0 0 328 303 303 304 228 229 230 231 232 233 234 235 236 231 232 233 234 235 236 236 286 311 231 232 233 234 235 236 0 0 0 1
1 0 0 0 0 0 0 0 353 328 328 329 253 254 255 256 257 258 259 260 261 256 257 258 259 260 261 261 311 336 211 257 258 259 260 261 0 0 0 1
1 0 0 0 0 0 0 0 378 353 353 354 278 279 280 281 282 283 284 285 286 281 282 283 284 285 286 286 336 361 211 282 283 284 285 286 0 0 0 1
1 0 0 0 0 0 0 0 0 378 378 379 303 304 305 306 307 308 309 310 311 306 307 308 309 310 311 311 361 386 236 307 308 309 310 311 0 0 0 1
1 0 0 0 0 0 0 0 0 0 0 0 328 329 330 331 332 333 334 335 336 331 332 333 334 335 336 336 386 260 261 332 333 334 335 336 0 0 0 1
1 0 0 0 0 0 0 0 0 0 0 0 353 354 355 356 357 358 359 360 361 356 357 358 359 360 361 361 284 285 286 357 358 359 360 361 0 0 0 1
1 0 0 0 0 0 0 0 0 0 0 0 378 379 380 381 382 383 384 385 386 381 382 383 384 385 386 386 309 310 311 382 383 384 385 386 0 0 0 1
1 0 0 0 0 0 0 0 0 0 0 0 0 0 0 0 0 0 0 0 0 0 328 329 330 331 332 333 334 335 336 0 0 0 0 0 0 0 0 1
1 0 0 0 0 0 0 0 0 0 0 0 0 0 0 0 0 0 0 0 0 0 353 354 355 356 357 358 359 360 361 0 0 0 0 0 0 0 0 1
1 0 0 0 0 0 0 0 0 0 0 0 0 0 0 0 0 0 0 0 0 0 378 379 380 381 382 383 384 385 386 0 0 0 0 0 0 0 0 1
1 0 0 0 0 0 0 0 0 0 0 0 0 0 0 0 0 0 0 0 0 0 0 0 0 0 0 0 0 0 0 0 0 0 0 0 0 0 0 1
1 1 1 1 1 1 1 1 1 1 1 1 1 1 1 1 1 1 1 1 1 1 1 1 1 1 1 1 1 1 1 1 1 1 1 1 1 1 1 1
