436 9 10 11 436 436 436 436 436 436 436 436 436 436 436 436 436 436 436 436 436 436 436 436 436 436 436 436 436 436 436 436 437 438 438 438 438 438 438 438
461 34 35 36 461 461 436 437 438 438 438 438 438 438 438 438 438 438 438 438 438 438 438 438 438 438 461 461 461 461 461 436 437 438 463 463 463 463 463 463
486 461 35 36 438 436 437 438 463 463 463 463 463 463 463 463 463 463 463 463 463 463 463 463 463 463 438 438 438 438 438 438 438 438 438 438 438 438 488 488
436 436 60 61 17 18 19 20 21 22 23 24 17 18 19 20 21 22 23 17 18 19 20 21 22 23 24 17 18 19 20 21 22 23 24 24 463 463 438 487
461 461 85 86 42 43 44 45 46 47 48 49 42 43 44 45 46 47 48 42 43 44 45 46 47 48 49 42 43 44 45 46 47 48 49 49 488 488 463 487
486 486 110 111 67 68 69 70 71 72 73 74 67 68 69 70 71 72 73 67 68 69 70 71 72 73 74 67 68 69 70 71 72 73 74 74 486 487 488 1
257 257 135 136 257 257 257 257 257 257 257 257 257 257 257 257 257 257 257 257 257 257 257 257 257 257 257 257 257 257 257 257 257 257 257 257 257 257 0 1
257 282 160 161 282 282 443 444 282 282 282 282 282 445 446 282 282 282 282 282 282 282 282 282 282 282 282 282 282 282 282 282 282 282 282 282 282 282 257 257
282 307 185 186 257 257 468 469 257 257 257 257 257 470 471 257 257 257 257 445 446 257 257 257 257 257 257 257 257 257 257 257 257 257 257 257 257 257 257 257
257 257 210 211 257 257 257 257 282 257 257 282 282 282 282 282 282 282 282 470 471 282 282 282 282 282 282 282 282 282 282 282 282 282 282 282 257 282 282 282
257 257 235 236 282 282 282 282 307 445 446 307 307 307 307 307 307 307 445 446 307 307 307 307 307 307 307 307 307 307 307 307 307 307 307 307 282 257 257 307
257 282 307 307 307 307 307 307 257 470 471 257 257 257 257 257 257 257 470 471 257 257 257 535 536 537 538 539 257 257 257 257 257 257 257 257 307 257 257 257
257 257 307 307 282 282 282 282 282 282 282 282 257 257 282 282 282 282 282 282 282 282 282 560 561 562 563 564 257 257 257 257 257 257 257 257 257 282 257 257
282 282 257 257 257 257 257 257 257 257 257 257 282 282 257 257 257 257 257 257 257 257 257 257 257 257 257 257 257 257 257 257 257 257 257 257 257 257 257 282
307 307 282 282 282 282 282 282 282 282 282 282 307 307 282 282 282 282 282 282 282 282 282 282 282 282 282 282 282 282 282 282 282 282 282 282 282 282 282 307
475 475 475 475 475 475 475 475 475 475 475 475 475 476 477 475 476 477 477 475 475 475 475 475 475 475 475 475 475 475 475 475 475 475 475 475 475 475 476 477
500 500 500 500 500 500 500 500 500 500 500 500 475 475 475 500 501 502 502 477 477 477 477 500 500 500 500 500 500 500 500 500 500 500 500 500 500 475 475 476
475 500 501 502 502 502 502 475 476 477 477 477 477 477 475 475 500 501 502 502 502 502 502 477 477 477 477 477 477 477 477 477 477 477 477 477 477 500 475 476
475 476 477 477 477 477 477 477 477 477 502 502 475 475 500 500 500 500 500 500 500 501 502 502 502 502 502 502 502 502 502 502 502 502 502 502 502 477 477 477
475 475 475 475 475 475 475 475 475 475 475 475 500 500 500 501 502 502 502 502 502 502 502 502 502 502 477 477 500 500 500 500 500 500 501 502 502 502 502 502
